GOMEXSI:NA	NA	GLOBI:UNKNOWN	UNKNOWN
GOMEXSI:parts	parts	GLOBI:UNKNOWN	UNKNOWN
GOMEXSI:pieces	parts	GLOBI:UNKNOWN	UNKNOWN
GOMEXSI:fragments	fragments	GLOBI:UNKNOWN	UNKNOWN
GOMEXSI:scales	scales	GLOBI:SCALES	SCALES
GOMEXSI:scale(s)	scale(s)	GLOBI:SCALES	SCALES
GOMEXSI:bone	bone	GLOBI:BONE	BONE
GOMEXSI:tube	tube	GLOBI:TUBE	TUBE
GOMEXSI:spine	spine	GLOBI:SPINE	SPINE
GOMEXSI:pollen_grain	pollen grain	GLOBI:POLLEN_GRAIN	POLLEN_GRAIN
GOMEXSI:opercula	opercula	GLOBI:OPERCULUM	OPERCULUM
GOMEXSI:caudal_spines	caudal_spines	GLOBI:CAUDAL_SPINE	CAUDAL_SPINE
GOMEXSI:shell	shell	GLOBI:SHELL	SHELL
GOMEXSI:needles	needles	GLOBI:NEEDLE	NEEDLE
GOMEXSI:seed_pod	seed pod	GLOBI:SEED_POD	SEED_POD
GOMEXSI:kernels	kernels	GLOBI:KERNEL	KERNEL
GOMEXSI:wood	wood	GLOBI:WOOD	WOOD
GOMEXSI:feather	feather	GLOBI:FEATHER	FEATHER
GOMEXSI:remains	remains	GLOBI:REMAINS	REMAINS
GOMEXSI:digestate	digestate	GLOBI:DIGESTATE	DIGESTATE
GOMEXSI:adult	adult	GLOBI:ADULT	ADULT
GOMEXSI:adults	adults	GLOBI:ADULT	ADULT
GOMEXSI:a	a	GLOBI:ADULT	ADULT
GOMEXSI:juvenile	juvenile	GLOBI:JUVENILE	JUVENILE
GOMEXSI:juvenile?	juvenile	GLOBI:JUVENILE	JUVENILE
GOMEXSI:j	j	GLOBI:JUVENILE	 JUVENILE
GOMEXSI:nd	nd	GLOBI:UNKNOWN	UNKOWN
GOMEXSI:na	na	GLOBI:UNKNOWN	UNKOWN
GOMEXSI:zoea	zoea	GLOBI:ZOEA	ZOEA
GOMEXSI:larvae	larvae	GLOBI:LARVA	LARVA
GOMEXSI:larval	larval	GLOBI:LARVA	LARVA
GOMEXSI:post larvae	post larvae	GLOBI:POSTLARVA	POSTLARVA
GOMEXSI:post-larvae	post-larvae	GLOBI:POSTLARVA	GLOBI:POSTLARVA
GOMEXSI:l/pl	l/pl	GLOBI:LARVA_OR_POSTLARVA	LARVA_OR_POSTLARVA
GOMEXSI:larvae/post larvae	larvae/post larvae	GLOBI:LARVA_OR_POSTLARVA	LARVA_OR_POSTLARVA
GOMEXSI:megalopa	megalopa	GLOBI:MEGALOPA	MEGALOPA
GOMEXSI:cypris	cypris	GLOBI:CYPRIS	CYPRIS
GOMEXSI:cyp	cyp	GLOBI:CYPRIS	CYPRIS
GOMEXSI:egg	egg	GLOBI:EGG	EGG
GOMEXSI:eggs	egg	GLOBI:EGG	EGG
GOMEXSI:nauplii	nauplii	GLOBI:NAUPLII	NAUPLII
GOMEXSI:copepodite	copepodite	GLOBI:COPEPODITE	COPEPODITE
GOMEXSI:copepodites	copepodites	GLOBI:COPEPODITE	COPEPODITE
GOMEXSI:copepedites	copepedites	GLOBI:COPEPODITE	COPEPODITE
GOMEXSI:glaucothoe	glaucothoe	GLOBI:GLAUCOTHOE	GLAUCOTHOE
GOMEXSI:veligers	veligers	GLOBI:VELIGER	VELIGER
GOMEXSI:newborn	newborn	GLOBI:NEWBORN	NEWBORN
BIO_INFO:mycelium	mycelium	GLOBI:MYCELIUM	MYCELIUM
BIO_INFO:larva	larva	GLOBI:LARVA	LARVA
BIO_INFO:aecium	aecium	GLOBI:AECIUM	AECIUM
BIO_INFO:pycnium	pycnium	GLOBI:PYCNIUM	PYCNIUM
BIO_INFO:sporangium	sporangium	GLOBI:SPORANGIUM	SPORANGIUM
BIO_INFO:uredium	uredium	GLOBI:UREDIUM	UREDIUM
BIO_INFO:caterpillar	caterpillar	GLOBI:CATERPILLAR	CATERPILLAR
BIO_INFO:adult	adult	GLOBI:ADULT	ADULT
BIO_INFO:egg	egg	GLOBI:EGG	EGG
BIO_INFO:nymph	nymph	GLOBI:NYMPH	NYMPH
BIO_INFO:telium	telium	GLOBI:TELIUM	TELIUM
BIO_INFO:anamorph	anamorph	GLOBI:ANAMORPH	ANAMORPH
BARNES:postlarva	postlarva	GLOBI:POSTLARVA	POSTLARVA
BARNES:postlarva/juvenile	postlarva/juvenile	GLOBI:POSTLARVA_OR_JUVENILE	POSTLARVA_OR_JUVENILE
BARNES:larva / juvenile	larva / juvenile	GLOBI:LARVA_OR_JUVENILE	LARVA_OR_JUVENILE
BARNES:larva	larva	GLOBI:LARVA	LARVA
BARNES:juvenile	juvenile	GLOBI:JUVENILE	JUVENILE
BARNES:adult	adult	GLOBI:ADULT	ADULT
BARNES:Adult	Adult	GLOBI:ADULT	ADULT
BAREMORE:Juv	Juv	GLOBI:JUVENILE	JUVENILE
BAREMORE:Mat	Mat	GLOBI:ADULT	ADULT
BAREMORE:Mat?	Mat?	GLOBI:PROBABLY_ADULT	PROBABLY_ADULT
BAREMORE:Trans	Trans	GLOBI:TRANS	TRANS
BAREMORE:Trans/Juv	Trans/Juv	GLOBI:TRANS_OR_JUVENILE	TRANS_OR_JUVENILE
BAREMORE:Yoy/Juv	Yoy/Juv	GLOBI:YOUNG_OF_THE_YEAR_OR_JUVENILE	YOUNG_OF_THE_YEAR_OR_JUVENILE
BAREMORE:Yoy	Yoy	GLOBI:YOUNG_OF_THE_YEAR	YOUNG_OF_THE_YEAR
BAREMORE:YOY	YOY	GLOBI:YOUNG_OF_THE_YEAR	YOUNG_OF_THE_YEAR
BAREMORE:Neo	Neo	GLOBI:NEO	NEO
